Hour_of_Day,Total_Posts,Total_Shares,Total_Comments,Total_Likes,Total_Engagements
7,3,7,18,269,294
8,4,17,40,448,505
9,4,30,57,542,629
10,5,121,225,1546,1892
11,4,112,203,1378,1693
12,3,81,155,1061,1297
13,5,114,228,1584,1926
14,4,126,224,1495,1845
15,3,119,209,1466,1794
16,3,116,211,1379,1706
17,3,100,183,1163,1446
18,2,37,68,565,670
19,3,28,52,475,555
20,2,70,118,771,959
21,2,119,202,1252,1573
